00000000000000000000000
000000000%000%000000000
00000001111111110000000
00000011h11a11h11000000
00000011111111111000000
0000001bb11111dd1000000
0000001br11111id1000000
02222211111111111222220
02222211111111111222220
02200011111111111000220
02200001111111110000220
02200000000000000000220
0220%0000000000000%0220
11111100222222200111111
1111g1002222222001f1111
11111100220002200111111
11111111110001111111111
1pp1111pp10001cc1111cc1
1hp1111ph10001hc1111ch1
11111111110001111111111
00002200000000000220000
000022000%000%000220000
00002201111111110220000
00002201h11111h10220000
00002221111$11112220000
00002221111@11112220000
00000001111111110000000
00000001111111110000000
