000000000000%00000000000000%0000%0
0000000000011111000000000011r11111
000000000001bbb10000002222p1r11111
000000000001111100%0002222p1r11111
0000000000011111111p22220011r11111
0000000000011111111p222200000sss11
0%00000000011@$11bb1000000000111pp
11111000000111111bb100000000000022
1ccc100000011111111100000%00000022
1111100%00000000000000001111000022
11h11p1110000000000000001ww10%0022
11g11p111000%00000%00000111111p1pp
1pp11p1pp0011111p1p12222p1i111p111
022000022001bbf1p1pp2222p111e1p111
022000022001bb11p1110000111111p111
02200002222p1111p11100000000000000
02200002222p111j100000000000000000
1111100000011111100000000000000000
1111100%00000000000000000000000000
11k11p11100000000000000%0000000000
11111p1v10000000000111p10000000000
11111p11100000000001bbp1x000000000
1www1p11p2222000%001bbpp0000000000
11111p11p222222p111111110000000000
000000000002222p111111z10000000000
00000000000000011111www10000000000
0000000000000001111111110000000000